R   2000 500
C  255,255,0
F  255,0,255
NO ./textures/purplestone.xpm
SO ./textures/bluestone.xpm
WE ./textures/bluestone.xpm
EA ./textures/bluestone.xpm
S  ./textures/pillar.xpm

1111
10001
1N001
11101
11111