R   500 500
C  255,255,0
F  255,0,255
NO ./textures/purplestone.xpm




SO    ./textures/bluestone.xpm



WE ./textures/bluestone.xpm




EA ./textures/bluestone.xpm



 11111
10001
10001
11N01
11111