R   500 500
C  255,255,0
F  255,0,255
NO ./textures/purplestone.xpm
SO ./textures/bluestone.xpm
WE ./textures/bluestone.xpm
EA ./textures/bluestone.xpm
S  ./textures/bluestone.xpm

1111
1001
1N001
11101
   1