R   500     500
F  220,100,125
C  221,102,255
NO ./textures/bluestone.xpm
SO ./textures/bluestone.xpm
WE ./textures/bluestone.xpm
EA ./textures/bluestone.xpm
S  ./textures/pillar.xpm

        1111111111111111111111111
        1000000000110000000000001
        1011000001110000002000001
        1001002000000000002200001
111111111011000001110000000000001
100000000001000001110111111111111
11110111111111011100000010001
11110111111111011101010010001
11000000110101011100000000001
10002000020000201100000000001
10000000002000001101010010001
11000001110101011111011110N0111
11110111 1110101 101111010001
11111111 1111111 111111111111
