R 500 500
NO	./textures/purplestone.xpm
SO	./textures/purplestone.xpm
WE	./textures/purplestone.xpm
EA  ./textures/purplestone.xpm
F	220,100,0
C	225,30,0





 111111
 11N011
 111111