dawdwadwa
wdadwadwadwadwa
1111111
11001111
1N 1 110111
1       1
