R 500 500
NO  ./textures/purplestone.xpm
SO	./textures/purplestone.xpm
WE	./textures/purplestone.xpm
EA  ./textures/purplestone.xpm
F   220,150,0
C   220,55,0


 111111
 11NN11
 111111